Age,Gender,Department,Experience_Years,Performance_Score,Salary,Engagement_Index,Performance_Category,Predicted_Salary,Residuals
49,Female,Operations,5,67,33013,6,Medium,40213,-7200
55,Female,Sales,5,70,42640,7,High,44344,-1704
29,Female,Sales,10,68,72180,7,Medium,64997,7183
30,Female,Operations,9,70,65750,7,High,63575,2175
58,Male,Sales,11,72,74830,7,High,73191,1639
46,Female,Sales,2,73,25481,7,High,29920,-4439
56,Male,Sales,9,85,72051,8,High,64320,7731
24,Female,IT,6,80,45430,8,High,49897,-4467
22,Female,Sales,3,70,37906,6,High,33983,3923
33,Female,Marketing,6,65,45616,6,Medium,45021,595
49,Female,Operations,7,70,53311,7,High,53959,-648
36,Female,HR,4,64,38576,6,Medium,35405,3171
27,Male,Sales,10,66,58485,6,Medium,64252,-5767
56,Female,Sales,6,74,45674,7,High,49152,-3478
54,Male,IT,12,83,83020,8,High,78744,4276
59,Female,Marketing,10,57,63726,5,Medium,63507,219
55,Female,Finance,4,63,32165,6,Medium,35405,-3240
48,Male,Sales,7,74,23299,7,High,53959,-30660
31,Female,HR,7,77,47076,7,High,53959,-6883
47,Male,Marketing,9,71,62767,7,High,63575,-808
56,Male,Sales,5,63,32226,6,Medium,40213,-7987
31,Female,Finance,8,79,62705,8,High,59512,3193
29,Male,Operations,8,64,49196,6,Medium,54637,-5441
47,Male,HR,7,78,46085,7,High,53959,-7874
24,Male,Sales,8,61,58172,6,Medium,54637,3535
40,Male,IT,3,72,39050,7,High,34728,4322
26,Male,IT,7,74,56560,7,High,53959,2601
26,Male,Sales,7,37,49109,3,Low,42619,6490
50,Female,Operations,9,66,68305,6,Medium,59444,8861
36,Male,Finance,3,62,22332,6,Medium,30597,-8265
56,Female,Operations,8,54,43800,5,Medium,53892,-10092
53,Male,Marketing,4,70,39064,6,High,38791,273
32,Female,HR,5,71,45765,7,High,44344,1421
35,Female,IT,1,65,23265,6,Medium,20982,2283
54,Female,Operations,9,63,54525,6,Medium,59444,-4919
49,Male,Marketing,7,71,59270,7,High,53959,5311
22,Female,Finance,7,59,51174,6,Medium,49829,1345
26,Male,IT,9,90,58842,9,High,65065,-6223
33,Male,Marketing,9,59,57743,6,Medium,59444,-1701
54,Female,HR,2,68,29528,6,Medium,25789,3739
33,Female,IT,4,74,48502,7,High,39536,8966
53,Female,Sales,4,73,42929,7,High,39536,3393
30,Female,Finance,8,68,56583,6,Medium,54637,1946
30,Female,IT,7,56,60442,5,Medium,49084,11358
43,Female,Finance,3,76,37819,7,High,34728,3091
50,Female,Finance,7,77,101904,7,High,53959,47945
52,Female,HR,8,79,67984,8,High,59512,8472
25,Female,IT,9,83,73791,8,High,64320,9471
53,Male,Finance,6,85,42026,8,High,49897,-7871
24,Male,Marketing,8,60,51536,6,Medium,54637,-3101
43,Female,Operations,2,85,29223,8,High,30665,-1442
47,Female,Sales,5,60,32131,6,Medium,40213,-8082
36,Male,Sales,2,57,27381,5,Medium,25044,2337
35,Female,IT,9,81,60697,8,High,64320,-3623
33,Female,Finance,5,71,42358,7,High,44344,-1986
45,Male,Sales,6,62,49544,6,Medium,45021,4523
39,Male,Marketing,8,70,57779,7,High,58767,-988
36,Male,HR,8,65,66987,6,Medium,54637,12350
47,Female,HR,7,68,53512,6,Medium,49829,3683
49,Female,IT,10,59,59270,6,Medium,64252,-4982
41,Female,HR,12,81,84888,8,High,78744,6144
32,Male,Sales,2,74,28543,7,High,29920,-1377
57,Male,Finance,3,67,43012,6,Medium,30597,12415
34,Female,HR,7,62,49495,6,Medium,49829,-334
30,Male,Finance,5,88,57081,8,High,45089,11992
42,Male,HR,13,85,87004,8,High,83551,3453
36,Male,Finance,6,66,45879,6,Medium,45021,858
26,Female,IT,5,68,39805,6,Medium,40213,-408
55,Male,Finance,12,71,76748,7,High,77999,-1251
48,Male,Operations,5,53,43702,5,Medium,39468,4234
43,Male,Sales,8,95,66624,9,High,60257,6367
53,Male,Operations,6,74,48250,7,High,49152,-902
42,Male,Marketing,3,68,25425,6,Medium,30597,-5172
45,Male,Operations,6,69,40376,6,Medium,45021,-4645
44,Female,IT,9,71,57664,7,High,63575,-5911
26,Female,Sales,1,85,22595,8,High,25857,-3262
33,Male,Marketing,10,64,66357,6,Medium,64252,2105
22,Male,Sales,6,66,50223,6,Medium,45021,5202
51,Female,IT,7,67,56146,6,Medium,49829,6317
31,Male,Sales,7,79,50560,7,High,53959,-3399
30,Male,Marketing,7,59,49518,6,Medium,49829,-311
47,Female,HR,11,59,53259,6,Medium,69060,-15801
45,Male,Operations,5,74,38899,7,High,44344,-5445
54,Female,HR,5,82,48402,8,High,45089,3313
32,Female,Marketing,7,70,56189,7,High,53959,2230
26,Female,IT,9,66,56536,6,Medium,59444,-2908
36,Male,HR,7,72,66434,7,High,53959,12475
40,Female,IT,9,73,60994,7,High,63575,-2581
51,Male,Marketing,6,55,39742,5,Medium,44276,-4534
31,Male,HR,2,67,25855,6,Medium,25789,66
41,Male,Operations,6,72,47896,7,High,49152,-1256
41,Male,HR,7,70,63991,7,High,53959,10032
38,Male,HR,6,75,45017,7,High,49152,-4135
33,Male,HR,3,71,36536,7,High,34728,1808
59,Male,Operations,7,78,66937,7,High,53959,12978
45,Female,Marketing,5,63,47090,6,Medium,40213,6877
45,Female,HR,11,63,70729,6,Medium,69060,1669
47,Female,IT,5,74,49078,7,High,44344,4734
42,Female,Marketing,4,48,33091,4,Medium,33915,-824
43,Male,HR,7,67,60666,6,Medium,49829,10837
25,Female,Sales,11,58,60375,6,Medium,69060,-8685
47,Female,Operations,5,54,48155,5,Medium,39468,8687
47,Female,Operations,10,86,66988,8,High,69128,-2140
40,Male,Sales,5,78,37396,7,High,44344,-6948
23,Male,IT,1,72,28550,7,High,25112,3438
36,Male,Sales,6,68,43249,6,Medium,45021,-1772
56,Male,HR,0,71,22973,6,High,19559,3414
56,Male,Operations,6,43,45242,4,Low,38556,6686
29,Female,HR,7,84,61224,8,High,54704,6520
43,Male,Sales,7,85,49547,8,High,54704,-5157
24,Male,Marketing,8,74,45080,7,High,58767,-13687
25,Female,HR,9,70,64465,7,High,63575,890
22,Female,Sales,8,70,51465,7,High,58767,-7302
30,Female,Marketing,8,67,57948,6,Medium,54637,3311
42,Male,HR,3,69,34285,6,Medium,30597,3688
33,Male,Sales,8,78,55094,7,High,58767,-3673
57,Male,Marketing,11,65,73445,6,Medium,69060,4385
22,Male,Finance,3,71,30369,7,High,34728,-4359
29,Female,HR,5,80,101904,7,High,44344,57560
58,Male,Sales,4,76,38649,7,High,39536,-887
48,Female,Finance,6,63,45524,6,Medium,45021,503
50,Female,Operations,4,59,32614,5,Medium,34660,-2046
26,Female,Finance,13,72,82124,7,High,82806,-682
48,Female,Finance,10,92,67195,9,High,69873,-2678
52,Female,IT,5,52,40464,5,Medium,39468,996
55,Male,HR,8,73,56948,7,High,58767,-1819
59,Male,Sales,13,76,93195,7,High,82806,10389
57,Female,Marketing,7,70,45688,7,High,53959,-8271
42,Male,Sales,9,66,61351,6,Medium,59444,1907
49,Male,Operations,7,75,55595,7,High,53959,1636
58,Male,Finance,5,81,44123,8,High,45089,-966
27,Male,HR,1,71,20000,6,High,24367,-4367
39,Male,Sales,10,69,59631,7,Medium,64997,-5366
38,Male,Operations,5,59,43163,5,Medium,39468,3695
34,Female,HR,4,65,46434,6,Medium,35405,11029
46,Female,Finance,10,70,70926,7,High,68383,2543
54,Male,Operations,6,85,42557,8,High,49897,-7340
33,Female,Marketing,3,71,28673,7,High,34728,-6055
51,Female,HR,8,71,54003,7,High,58767,-4764
54,Female,Marketing,8,60,52335,6,Medium,54637,-2302
54,Male,Operations,3,75,28276,7,High,34728,-6452
27,Female,Marketing,3,73,30030,7,High,34728,-4698
45,Female,Sales,9,67,56167,6,Medium,59444,-3277
43,Male,Marketing,9,68,64414,6,Medium,59444,4970
28,Male,HR,2,65,29822,6,Medium,25789,4033
23,Female,HR,5,66,39412,6,Medium,40213,-801
35,Female,HR,9,70,63628,7,High,63575,53
45,Male,Operations,7,81,50264,8,High,54704,-4440
26,Female,HR,8,64,53293,6,Medium,54637,-1344
57,Male,Sales,5,62,35743,6,Medium,40213,-4470
31,Male,IT,13,54,75789,5,Medium,77931,-2142
44,Male,HR,11,71,76338,7,High,73191,3147
33,Female,Finance,5,59,42776,5,Medium,39468,3308
37,Male,Finance,7,63,45867,6,Medium,49829,-3962
46,Female,Marketing,10,79,60344,8,High,69128,-8784
42,Male,Operations,2,68,21468,6,Medium,25789,-4321
35,Male,Marketing,0,59,20000,5,Medium,15429,4571
34,Male,Finance,7,81,45861,8,High,54704,-8843
28,Male,Sales,5,85,50730,8,High,45089,5641
37,Female,HR,9,71,56780,7,High,63575,-6795
22,Male,Finance,14,53,83455,5,Medium,82739,716
29,Male,Finance,9,76,55130,7,High,63575,-8445
56,Female,HR,0,58,20000,5,Medium,15429,4571
43,Female,Finance,6,69,35894,6,Medium,45021,-9127
57,Female,Operations,11,80,71269,8,High,73936,-2667
53,Female,Marketing,7,61,56168,6,Medium,49829,6339
42,Male,IT,12,80,81080,8,High,78744,2336
22,Male,Operations,8,63,62641,6,Medium,54637,8004
54,Female,IT,0,72,20000,6,High,19559,441
39,Male,Marketing,8,77,60584,7,High,58767,1817
30,Male,Finance,8,70,68166,7,High,58767,9399
58,Male,IT,9,49,52238,5,Medium,58699,-6461
37,Male,IT,14,76,84363,7,High,87614,-3251
34,Male,IT,12,69,72583,7,Medium,74613,-2030
29,Male,Finance,7,76,45376,7,High,53959,-8583
40,Female,HR,5,65,41051,6,Medium,40213,838
59,Male,Finance,9,71,64455,7,High,63575,880
47,Male,Marketing,2,77,28954,7,High,29920,-966
33,Female,Finance,5,54,40644,5,Medium,39468,1176
38,Female,HR,8,80,46900,8,High,59512,-12612
59,Male,Finance,12,83,84012,8,High,78744,5268
57,Male,Sales,8,72,66856,7,High,58767,8089
45,Male,HR,8,85,64734,8,High,59512,5222
25,Female,Operations,3,66,33339,6,Medium,30597,2742
42,Female,Operations,6,65,42180,6,Medium,45021,-2841
35,Female,Finance,11,67,66127,6,Medium,69060,-2933
49,Male,Marketing,12,68,68751,7,Medium,74613,-5862
59,Male,Finance,12,54,66632,5,Medium,73123,-6491
53,Female,Marketing,11,60,66539,6,Medium,69060,-2521
32,Male,Marketing,4,54,30491,5,Medium,34660,-4169
30,Male,Marketing,5,67,37188,6,Medium,40213,-3025
34,Female,HR,0,71,20000,6,High,19559,441
29,Female,IT,3,73,41649,7,High,34728,6921
23,Male,IT,14,50,79978,5,Medium,82739,-2761
33,Male,Sales,4,70,32037,6,High,38791,-6754
47,Female,Marketing,5,60,37381,6,Medium,40213,-2832
49,Male,Sales,7,71,48062,7,High,53959,-5897
44,Female,IT,10,66,62189,6,Medium,64252,-2063
40,Male,Operations,5,83,48629,8,High,45089,3540
44,Female,Sales,6,76,49924,7,High,49152,772
27,Female,IT,6,86,47198,8,High,49897,-2699
53,Male,Operations,7,63,53987,6,Medium,49829,4158
29,Male,Operations,0,71,20000,6,High,19559,441
43,Female,Finance,12,75,78237,7,High,77999,238
46,Female,Sales,9,72,61385,7,High,63575,-2190
27,Female,HR,3,76,28155,7,High,34728,-6573
39,Male,Operations,12,82,76489,8,High,78744,-2255
23,Female,HR,9,63,57217,6,Medium,59444,-2227
54,Female,Operations,6,74,57935,7,High,49152,8783
48,Male,Sales,9,71,64369,7,High,63575,794
29,Female,Marketing,12,67,73586,7,Medium,74613,-1027
36,Male,Operations,9,65,61326,6,Medium,59444,1882
57,Female,Marketing,10,88,72001,8,High,69128,2873
54,Male,Marketing,9,75,62658,7,High,63575,-917
42,Female,Marketing,10,60,68188,6,Medium,64252,3936
44,Male,Finance,9,68,55890,6,Medium,59444,-3554
41,Male,IT,7,67,48010,6,Medium,49829,-1819
58,Male,Marketing,7,71,56643,7,High,53959,2684
45,Female,Marketing,2,65,23868,6,Medium,25789,-1921
28,Male,Sales,7,74,53048,7,High,53959,-911
43,Male,Operations,0,72,20000,6,High,19559,441
27,Female,Marketing,0,76,23066,7,High,20304,2762
42,Female,IT,4,79,40439,7,High,39536,903
55,Female,Finance,6,70,45026,7,High,49152,-4126
47,Female,Finance,5,81,42469,8,High,45089,-2620
54,Female,Finance,5,59,42739,5,Medium,39468,3271
54,Female,Operations,2,67,33078,6,Medium,25789,7289
26,Female,Marketing,3,69,36643,6,Medium,30597,6046
26,Male,IT,11,85,72231,8,High,73936,-1705
39,Male,Sales,4,77,34120,7,High,39536,-5416
34,Male,Finance,5,79,47109,7,High,44344,2765
46,Female,HR,4,68,28616,6,Medium,35405,-6789
34,Male,HR,3,64,25811,6,Medium,30597,-4786
56,Female,Finance,6,53,38693,5,Medium,44276,-5583
23,Female,Operations,5,58,37800,5,Medium,39468,-1668
41,Male,Operations,5,73,44925,7,High,44344,581
44,Male,Sales,6,79,61269,7,High,49152,12117
51,Female,Operations,4,53,39571,5,Medium,34660,4911
27,Female,IT,11,64,68921,6,Medium,69060,-139
52,Female,Operations,10,76,66626,7,High,68383,-1757
37,Female,HR,9,73,50771,7,High,63575,-12804
58,Male,Finance,9,54,61707,5,Medium,58699,3008
46,Male,Sales,4,71,39462,7,High,39536,-74
49,Male,Sales,4,70,30385,6,High,38791,-8406
40,Male,Sales,5,65,40812,6,Medium,40213,599
49,Male,Marketing,9,80,58823,8,High,64320,-5497
27,Male,HR,9,75,61321,7,High,63575,-2254
54,Female,Operations,8,70,57080,7,High,58767,-1687
29,Male,Finance,3,65,26636,6,Medium,30597,-3961
27,Male,IT,11,67,71696,6,Medium,69060,2636
50,Female,Operations,7,80,54210,8,High,54704,-494
26,Male,HR,0,86,22451,8,High,21049,1402
29,Male,Marketing,11,78,61608,8,High,73936,-12328
52,Female,Marketing,9,63,52425,6,Medium,59444,-7019
25,Female,Sales,4,64,36307,6,Medium,35405,902
25,Male,HR,4,68,38774,6,Medium,35405,3369
22,Female,Finance,7,67,57008,6,Medium,49829,7179
25,Female,Marketing,5,53,44356,5,Medium,39468,4888
46,Female,Marketing,0,70,22658,6,High,19559,3099
50,Male,Operations,7,79,57445,7,High,53959,3486
51,Male,Sales,7,74,61129,7,High,53959,7170
35,Male,Marketing,11,70,74531,7,High,73191,1340
29,Female,Sales,7,55,48575,5,Medium,49084,-509
54,Male,Operations,9,94,57637,9,High,65065,-7428
50,Female,HR,10,76,66495,7,High,68383,-1888
56,Female,Marketing,6,77,45075,7,High,49152,-4077
45,Male,Finance,8,57,52119,5,Medium,53892,-1773
44,Male,Marketing,6,76,39168,7,High,49152,-9984
31,Female,Operations,10,64,61999,6,Medium,64252,-2253
46,Male,HR,12,69,80809,7,Medium,74613,6196
23,Male,HR,3,60,20000,5,Medium,29852,-9852
59,Male,Sales,12,78,80790,8,High,78744,2046
26,Male,Sales,7,70,54978,7,High,53959,1019
44,Female,Finance,7,68,48882,6,Medium,49829,-947
29,Male,Marketing,8,78,60648,7,High,58767,1881
39,Male,Operations,9,68,52543,6,Medium,59444,-6901
43,Female,HR,7,68,53200,6,Medium,49829,3371
44,Male,Marketing,4,65,29973,6,Medium,35405,-5432
54,Male,IT,4,84,33406,8,High,40281,-6875
50,Female,IT,6,77,44623,7,High,49152,-4529
54,Male,IT,6,63,48823,6,Medium,45021,3802
45,Male,Finance,9,62,63063,6,Medium,59444,3619
46,Male,Marketing,11,55,59701,5,Medium,68315,-8614
54,Female,Sales,5,54,40536,5,Medium,39468,1068
50,Female,IT,10,68,65871,7,Medium,64997,874
48,Female,Marketing,6,87,48673,8,High,49897,-1224
27,Female,Marketing,8,59,50396,6,Medium,54637,-4241
51,Female,Finance,3,64,26975,6,Medium,30597,-3622
57,Female,Marketing,5,83,44608,8,High,45089,-481
28,Male,HR,11,82,73145,8,High,73936,-791
52,Female,IT,7,66,46132,6,Medium,49829,-3697
34,Male,Finance,7,67,52125,6,Medium,49829,2296
57,Female,Operations,7,80,54093,8,High,54704,-611
41,Female,Operations,8,59,50667,6,Medium,54637,-3970
31,Male,Sales,7,68,59385,6,Medium,49829,9556
29,Male,HR,7,72,50655,7,High,53959,-3304
45,Male,IT,8,78,61864,7,High,58767,3097
26,Male,Finance,8,73,60557,7,High,58767,1790
55,Male,Marketing,0,70,20000,6,High,19559,441
23,Female,Operations,7,72,31096,7,High,53959,-22863
45,Male,Finance,7,59,37818,6,Medium,49829,-12011
47,Male,Marketing,4,49,30299,4,Medium,33915,-3616
59,Female,HR,7,74,59361,7,High,53959,5402
42,Male,HR,11,81,69325,8,High,73936,-4611
54,Female,IT,6,70,39299,7,High,49152,-9853
32,Male,Marketing,5,70,41113,7,High,44344,-3231
46,Female,Marketing,6,70,51444,7,High,49152,2292
22,Female,HR,12,75,83779,7,High,77999,5780
57,Female,HR,14,55,88101,5,Medium,82739,5362
45,Female,IT,11,83,73407,8,High,73936,-529
53,Male,Marketing,9,71,57942,7,High,63575,-5633
55,Male,Operations,6,68,36700,6,Medium,45021,-8321
31,Male,Operations,5,79,42673,7,High,44344,-1671
29,Male,Finance,3,83,36128,8,High,35473,655
58,Male,Sales,11,69,66961,7,Medium,69805,-2844
32,Female,IT,4,66,31809,6,Medium,35405,-3596
23,Female,HR,13,70,90808,7,High,82806,8002
55,Male,IT,10,61,72927,6,Medium,64252,8675
25,Female,IT,8,80,61669,8,High,59512,2157
29,Female,IT,4,67,31042,6,Medium,35405,-4363
37,Male,Operations,7,66,20079,6,Medium,49829,-29750
22,Female,Sales,6,66,43656,6,Medium,45021,-1365
46,Male,Marketing,6,52,38758,5,Medium,44276,-5518
34,Female,IT,11,47,64509,5,Medium,68315,-3806
22,Male,Marketing,8,40,52406,4,Low,48172,4234
42,Female,Marketing,13,72,79862,7,High,82806,-2944
34,Male,Marketing,7,62,54728,6,Medium,49829,4899
31,Female,Marketing,7,57,67273,5,Medium,49084,18189
56,Male,Marketing,7,85,57735,8,High,54704,3031
47,Male,Operations,8,53,51886,5,Medium,53892,-2006
47,Female,Marketing,7,68,47259,6,Medium,49829,-2570
34,Female,IT,10,71,70745,7,High,68383,2362
46,Female,Finance,7,58,44303,5,Medium,49084,-4781
29,Female,Sales,11,87,77157,8,High,73936,3221
38,Male,HR,6,90,43961,8,High,49897,-5936
34,Female,Finance,13,81,77062,8,High,83551,-6489
23,Male,Operations,10,71,70825,7,High,68383,2442
32,Male,Sales,10,86,75098,8,High,69128,5970
54,Male,Finance,5,66,43797,6,Medium,40213,3584
38,Male,Sales,3,71,24381,7,High,34728,-10347
22,Male,IT,6,70,44352,7,High,49152,-4800
47,Female,Marketing,9,74,59841,7,High,63575,-3734
47,Male,Marketing,10,81,62395,8,High,69128,-6733
43,Male,Marketing,11,82,70356,8,High,73936,-3580
32,Male,Sales,6,92,52471,9,High,50642,1829
53,Female,Operations,3,84,30079,8,High,35473,-5394
41,Female,Sales,5,66,39584,6,Medium,40213,-629
38,Female,Operations,3,71,31500,7,High,34728,-3228
28,Male,Sales,7,85,50228,8,High,54704,-4476
42,Female,HR,8,69,46133,7,Medium,55381,-9248
57,Female,IT,4,65,30262,6,Medium,35405,-5143
22,Female,Operations,7,82,56404,8,High,54704,1700
50,Female,Marketing,10,61,61263,6,Medium,64252,-2989
37,Female,Sales,5,57,37036,5,Medium,39468,-2432
35,Female,Sales,6,69,50279,6,Medium,45021,5258
59,Male,Finance,4,75,37525,7,High,39536,-2011
35,Male,Marketing,7,72,50783,7,High,53959,-3176
41,Female,Sales,7,70,57102,7,High,53959,3143
29,Female,Finance,5,56,49733,5,Medium,39468,10265
22,Female,Operations,6,55,39937,5,Medium,44276,-4339
53,Female,Sales,5,77,44890,7,High,44344,546
53,Female,Marketing,7,76,59203,7,High,53959,5244
31,Male,HR,5,75,42445,7,High,44344,-1899
49,Male,Marketing,8,57,62570,5,Medium,53892,8678
32,Female,IT,11,66,66367,6,Medium,69060,-2693
48,Male,IT,6,77,44331,7,High,49152,-4821
33,Male,Operations,3,59,34735,5,Medium,29852,4883
39,Male,Operations,8,66,58234,6,Medium,54637,3597
43,Female,Operations,2,62,26757,6,Medium,25789,968
50,Female,Operations,4,62,36358,6,Medium,35405,953
49,Male,Finance,2,88,23123,8,High,30665,-7542
25,Male,HR,5,75,35894,7,High,44344,-8450
50,Female,HR,4,55,32891,5,Medium,34660,-1769
46,Male,Marketing,11,65,61113,6,Medium,69060,-7947
49,Female,Marketing,3,69,26889,6,Medium,30597,-3708
23,Male,Operations,4,57,36533,5,Medium,34660,1873
53,Female,Marketing,14,68,77398,7,Medium,84229,-6831
43,Female,Marketing,7,48,47332,4,Medium,48339,-1007
29,Male,Operations,10,71,77150,7,High,68383,8767
37,Male,Sales,8,67,62263,6,Medium,54637,7626
42,Male,Sales,13,71,83599,7,High,82806,793
36,Female,HR,7,78,48258,7,High,53959,-5701
32,Female,Sales,7,49,53277,5,Medium,49084,4193
55,Female,IT,0,62,20000,6,Medium,16174,3826
53,Female,Marketing,9,76,101904,7,High,63575,38329
58,Male,Operations,11,75,75667,7,High,73191,2476
31,Male,Operations,10,58,62086,6,Medium,64252,-2166
47,Male,IT,5,67,40949,6,Medium,40213,736
27,Female,Sales,4,74,36534,7,High,39536,-3002
55,Female,Finance,1,71,28970,6,High,24367,4603
47,Female,HR,9,61,58725,6,Medium,59444,-719
57,Female,Operations,5,43,30636,4,Low,33748,-3112
48,Female,HR,3,72,25713,7,High,34728,-9015
25,Male,HR,9,73,61392,7,High,63575,-2183
32,Female,IT,9,81,63297,8,High,64320,-1023
48,Male,Finance,9,73,65686,7,High,63575,2111
46,Male,HR,10,81,70097,8,High,69128,969
28,Female,Marketing,2,73,37693,7,High,29920,7773
58,Female,Sales,9,63,52867,6,Medium,59444,-6577
39,Male,Marketing,4,68,37577,6,Medium,35405,2172
39,Female,IT,9,67,63362,6,Medium,59444,3918
48,Female,Finance,5,67,41239,6,Medium,40213,1026
47,Female,Marketing,10,74,64997,7,High,68383,-3386
56,Female,Finance,10,71,67887,7,High,68383,-496
40,Male,Operations,5,62,27233,6,Medium,40213,-12980
23,Male,IT,8,72,56355,7,High,58767,-2412
26,Female,HR,10,79,101904,8,High,69128,32776
49,Female,Finance,11,71,71978,7,High,73191,-1213
32,Female,Marketing,3,72,35850,7,High,34728,1122
38,Female,IT,2,76,30441,7,High,29920,521
30,Male,IT,6,57,39076,5,Medium,44276,-5200
28,Female,IT,4,76,52339,7,High,39536,12803
34,Male,IT,8,77,56350,7,High,58767,-2417
35,Male,Marketing,7,64,55187,6,Medium,49829,5358
56,Male,Operations,5,66,35276,6,Medium,40213,-4937
57,Female,Operations,6,68,45948,6,Medium,45021,927
31,Female,Sales,13,84,81370,8,High,83551,-2181
30,Female,Marketing,7,64,41226,6,Medium,49829,-8603
41,Female,Sales,10,80,60900,8,High,69128,-8228
35,Female,Operations,0,70,20000,6,High,19559,441
49,Female,Operations,8,65,51646,6,Medium,54637,-2991
58,Male,Operations,5,54,34794,5,Medium,39468,-4674
29,Female,IT,4,70,41249,6,High,38791,2458
40,Male,Operations,8,74,63601,7,High,58767,4834
47,Male,Marketing,8,67,66610,6,Medium,54637,11973
30,Male,Marketing,12,67,80476,7,Medium,74613,5863
30,Male,Finance,11,64,70308,6,Medium,69060,1248
53,Male,Operations,4,78,42286,7,High,39536,2750
50,Female,Marketing,8,94,64431,9,High,60257,4174
51,Female,HR,10,57,57268,5,Medium,63507,-6239
22,Male,Finance,4,72,39010,7,High,39536,-526
48,Male,Sales,7,82,46272,8,High,54704,-8432
42,Female,Marketing,6,73,45187,7,High,49152,-3965
22,Female,IT,12,59,76048,6,Medium,73868,2180
33,Female,Operations,0,86,23980,8,High,21049,2931
39,Female,Sales,11,84,78043,8,High,73936,4107
26,Female,Marketing,4,74,29456,7,High,39536,-10080
34,Female,Finance,3,60,36887,5,Medium,29852,7035
59,Male,Sales,10,81,69831,8,High,69128,703
42,Male,Finance,3,76,29332,7,High,34728,-5396
28,Male,Finance,0,71,20000,6,High,19559,441
56,Female,Marketing,8,66,52049,6,Medium,54637,-2588
46,Male,HR,6,63,44109,6,Medium,45021,-912
37,Female,Operations,3,60,30208,5,Medium,29852,356
56,Male,Marketing,6,75,43061,7,High,49152,-6091
35,Male,Marketing,10,75,71008,7,High,68383,2625
30,Female,Operations,8,55,58282,5,Medium,53892,4390
56,Female,Operations,10,83,63899,8,High,69128,-5229
42,Male,HR,3,58,29510,5,Medium,29852,-342
37,Male,HR,9,77,64154,7,High,63575,579
22,Female,Finance,1,64,21168,6,Medium,20982,186
44,Female,Finance,8,77,60180,7,High,58767,1413
56,Female,Finance,11,67,64606,6,Medium,69060,-4454
43,Male,IT,8,53,52167,5,Medium,53892,-1725
32,Female,Operations,7,73,53325,7,High,53959,-634
58,Male,Finance,10,71,70837,7,High,68383,2454
48,Male,Finance,7,81,56843,8,High,54704,2139
49,Male,Operations,9,73,66186,7,High,63575,2611
41,Male,Sales,11,72,101904,7,High,73191,28713
48,Male,Marketing,8,66,50883,6,Medium,54637,-3754
38,Male,Operations,7,51,48659,5,Medium,49084,-425
24,Female,Sales,9,67,60490,6,Medium,59444,1046
37,Female,Operations,11,57,65437,5,Medium,68315,-2878
33,Male,Marketing,8,70,51628,7,High,58767,-7139
46,Female,Sales,6,49,37001,5,Medium,44276,-7275
35,Female,Finance,1,77,20000,7,High,25112,-5112
59,Female,HR,8,66,59826,6,Medium,54637,5189
37,Female,IT,8,65,63413,6,Medium,54637,8776
51,Female,Sales,3,66,35480,6,Medium,30597,4883
57,Male,Sales,6,61,42293,6,Medium,45021,-2728
56,Male,HR,6,69,41668,6,Medium,45021,-3353
54,Male,Marketing,8,74,57372,7,High,58767,-1395
53,Male,IT,9,67,58440,6,Medium,59444,-1004
58,Male,Operations,5,66,31277,6,Medium,40213,-8936
41,Male,Sales,5,63,28612,6,Medium,40213,-11601
59,Female,HR,2,48,24506,4,Medium,24299,207
59,Female,HR,2,73,31040,7,High,29920,1120
29,Male,Marketing,14,58,80522,6,Medium,83484,-2962
26,Male,IT,3,69,35947,6,Medium,30597,5350
24,Female,Finance,2,59,20781,5,Medium,25044,-4263
30,Female,HR,0,66,20000,6,Medium,16174,3826
47,Female,IT,5,81,46950,8,High,45089,1861
39,Male,Operations,7,62,49377,6,Medium,49829,-452
48,Male,HR,2,70,25697,6,High,29175,-3478
52,Male,Sales,8,78,54884,7,High,58767,-3883
24,Male,HR,3,66,33762,6,Medium,30597,3165
34,Female,IT,9,70,57822,7,High,63575,-5753
34,Male,HR,6,71,101904,7,High,49152,52752
38,Female,Marketing,7,69,48795,6,Medium,49829,-1034
51,Female,Sales,8,75,64598,7,High,58767,5831
54,Male,Marketing,7,77,65015,7,High,53959,11056
54,Male,HR,4,70,39874,6,High,38791,1083
26,Female,Finance,5,67,46678,6,Medium,40213,6465
29,Male,Finance,5,81,41315,8,High,45089,-3774
25,Female,Sales,6,62,39234,6,Medium,45021,-5787
35,Female,Operations,11,50,58866,5,Medium,68315,-9449
26,Male,IT,4,59,20000,5,Medium,34660,-14660
58,Female,Sales,3,70,33982,6,High,33983,-1
36,Male,HR,0,62,20000,6,Medium,16174,3826
38,Female,Marketing,8,76,52128,7,High,58767,-6639
36,Male,IT,8,79,48811,8,High,59512,-10701
45,Female,Marketing,4,52,32057,5,Medium,34660,-2603
24,Female,Marketing,9,72,65903,7,High,63575,2328
25,Female,Sales,4,71,31437,7,High,39536,-8099
39,Female,IT,8,58,53272,5,Medium,53892,-620
56,Female,HR,4,86,40640,8,High,40281,359
29,Female,HR,6,73,49161,7,High,49152,9
40,Male,Operations,11,84,75619,8,High,73936,1683
50,Female,Sales,7,67,5000,6,Medium,49829,-44829
23,Female,Finance,7,57,51694,5,Medium,49084,2610
50,Male,IT,10,67,101904,6,Medium,64252,37652
54,Female,Marketing,10,79,67142,8,High,69128,-1986
45,Female,Marketing,11,56,101904,5,Medium,68315,33589
46,Female,Operations,5,73,39007,7,High,44344,-5337
51,Male,Operations,3,76,35432,7,High,34728,704
26,Female,HR,3,67,29888,6,Medium,30597,-709
51,Female,Sales,14,97,88587,10,High,89849,-1262
58,Female,Finance,8,65,53001,6,Medium,54637,-1636
53,Female,Finance,3,83,32190,8,High,35473,-3283
52,Female,Operations,7,85,49287,8,High,54704,-5417
24,Female,IT,7,67,53520,6,Medium,49829,3691
55,Male,Finance,9,57,53581,5,Medium,58699,-5118
24,Female,IT,7,64,34557,6,Medium,49829,-15272
46,Male,Marketing,7,58,46627,5,Medium,49084,-2457
55,Female,Finance,16,68,96430,7,Medium,93844,2586
31,Male,Operations,5,69,45521,6,Medium,40213,5308
57,Female,IT,4,90,46315,8,High,40281,6034
56,Male,IT,8,73,66199,7,High,58767,7432
28,Female,Operations,12,79,83399,8,High,78744,4655
51,Male,HR,3,70,37241,6,High,33983,3258
32,Female,Operations,11,80,83244,8,High,73936,9308
49,Female,IT,7,80,60674,8,High,54704,5970
57,Female,Operations,1,59,20000,5,Medium,20237,-237
44,Male,Sales,10,58,65990,6,Medium,64252,1738
58,Male,IT,8,59,50698,6,Medium,54637,-3939
46,Male,Marketing,6,68,48591,6,Medium,45021,3570
57,Female,IT,7,60,46654,6,Medium,49829,-3175
54,Male,Sales,8,77,56178,7,High,58767,-2589
29,Male,Finance,9,60,50388,6,Medium,59444,-9056
50,Male,Marketing,8,70,58470,7,High,58767,-297
45,Male,Operations,7,76,81487,7,High,53959,27528
45,Male,IT,10,84,71363,8,High,69128,2235
38,Male,Operations,6,84,47104,8,High,49897,-2793
39,Female,Operations,4,70,40718,6,High,38791,1927
50,Male,Finance,11,56,66885,5,Medium,68315,-1430
25,Male,Marketing,6,80,56595,8,High,49897,6698
50,Female,Marketing,9,63,51810,6,Medium,59444,-7634
44,Male,Finance,8,65,53784,6,Medium,54637,-853
25,Female,HR,8,66,60704,6,Medium,54637,6067
56,Female,Finance,7,70,54270,7,High,53959,311
25,Male,Marketing,11,69,69005,7,Medium,69805,-800
25,Male,Sales,9,69,58070,7,Medium,60189,-2119
28,Female,Operations,4,56,34187,5,Medium,34660,-473
53,Male,Finance,4,79,36513,7,High,39536,-3023
40,Male,IT,5,63,45600,6,Medium,40213,5387
47,Female,Finance,7,69,51735,6,Medium,49829,1906
35,Female,Operations,4,82,38239,8,High,40281,-2042
53,Male,IT,8,79,57448,8,High,59512,-2064
47,Female,IT,8,77,61423,7,High,58767,2656
43,Male,Sales,8,70,58839,7,High,58767,72
54,Male,Marketing,10,71,60885,7,High,68383,-7498
57,Female,IT,7,51,49544,5,Medium,49084,460
58,Female,Operations,12,57,81402,6,Medium,73868,7534
40,Male,Operations,4,78,49147,7,High,39536,9611
58,Female,IT,11,97,85515,9,High,74681,10834
55,Female,HR,3,81,23137,7,High,34728,-11591
24,Female,HR,2,61,26606,6,Medium,25789,817
55,Male,Sales,11,63,72542,6,Medium,69060,3482
56,Male,HR,9,62,63098,6,Medium,59444,3654
42,Female,Operations,7,56,43925,5,Medium,49084,-5159
30,Female,Marketing,5,58,37847,5,Medium,39468,-1621
37,Female,Marketing,9,70,60197,7,High,63575,-3378
24,Female,Finance,8,58,46244,5,Medium,53892,-7648
28,Female,Marketing,12,65,73677,6,Medium,73868,-191
45,Male,HR,6,71,50512,7,High,49152,1360
34,Male,Operations,5,77,47147,7,High,44344,2803
40,Male,Finance,5,58,48946,5,Medium,39468,9478
54,Female,Operations,6,62,41540,6,Medium,45021,-3481
25,Male,Marketing,4,86,32062,8,High,40281,-8219
33,Male,Sales,6,78,52685,7,High,49152,3533
50,Male,IT,5,60,38488,6,Medium,40213,-1725
24,Male,IT,4,74,31863,7,High,39536,-7673
49,Female,Operations,8,61,53867,6,Medium,54637,-770
37,Male,Operations,1,85,26994,8,High,25857,1137
57,Male,HR,7,59,53926,6,Medium,49829,4097
36,Female,Marketing,8,87,60785,8,High,59512,1273
54,Female,Marketing,3,60,30387,5,Medium,29852,535
22,Male,Finance,11,45,69819,4,Medium,67570,2249
33,Female,IT,11,68,70583,7,Medium,69805,778
41,Female,Operations,4,70,38173,6,High,38791,-618
56,Male,Finance,6,54,46417,5,Medium,44276,2141
37,Male,Sales,7,84,53275,8,High,54704,-1429
24,Male,Finance,13,67,79135,7,Medium,79421,-286
23,Male,Finance,11,80,74224,8,High,73936,288
38,Male,Sales,5,51,41772,5,Medium,39468,2304
54,Male,Sales,7,88,55048,8,High,54704,344
56,Male,Marketing,6,84,44293,8,High,49897,-5604
32,Female,HR,9,64,59999,6,Medium,59444,555
25,Male,Operations,5,61,34260,6,Medium,40213,-5953
23,Female,HR,6,61,42502,6,Medium,45021,-2519
33,Female,Marketing,8,78,56234,7,High,58767,-2533
44,Female,Sales,8,68,55119,6,Medium,54637,482
31,Female,Finance,6,95,54789,9,High,50642,4147
49,Male,Operations,5,73,46281,7,High,44344,1937
58,Male,HR,7,84,52636,8,High,54704,-2068
23,Female,IT,8,58,54880,5,Medium,53892,988
43,Female,Sales,8,66,58872,6,Medium,54637,4235
55,Male,Finance,7,63,56266,6,Medium,49829,6437
43,Male,Sales,7,53,44921,5,Medium,49084,-4163
24,Male,Marketing,4,69,37883,6,Medium,35405,2478
49,Female,Marketing,6,54,37541,5,Medium,44276,-6735
41,Female,HR,11,72,62991,7,High,73191,-10200
53,Male,Operations,6,77,53429,7,High,49152,4277
52,Female,Marketing,6,57,43883,5,Medium,44276,-393
27,Male,Finance,11,72,74421,7,High,73191,1230
27,Male,Sales,6,68,52325,6,Medium,45021,7304
47,Male,Operations,5,74,45674,7,High,44344,1330
58,Female,Sales,10,75,67042,7,High,68383,-1341
23,Male,Sales,9,86,57913,8,High,64320,-6407
58,Female,Operations,10,78,64619,7,High,68383,-3764
48,Female,Marketing,10,82,63791,8,High,69128,-5337
32,Female,Sales,7,80,61068,8,High,54704,6364
48,Male,Operations,6,67,44468,6,Medium,45021,-553
38,Male,Finance,6,72,51016,7,High,49152,1864
27,Female,Sales,5,63,30843,6,Medium,40213,-9370
58,Female,IT,13,70,82905,7,High,82806,99
27,Female,Finance,5,47,39110,4,Medium,38723,387
27,Female,HR,13,57,74264,6,Medium,78676,-4412
59,Female,HR,4,83,38321,8,High,40281,-1960
46,Female,HR,7,63,33501,6,Medium,49829,-16328
23,Male,Sales,9,69,58868,7,Medium,60189,-1321
49,Male,HR,8,50,53517,5,Medium,53892,-375
26,Female,Sales,6,52,46512,5,Medium,44276,2236
52,Female,Operations,6,59,44699,5,Medium,44276,423
50,Male,HR,7,76,55111,7,High,53959,1152
57,Male,HR,7,73,40223,7,High,53959,-13736
56,Male,Finance,16,65,101904,6,Medium,93099,8805
39,Female,HR,0,74,20000,7,High,20304,-304
31,Male,Sales,6,38,30199,3,Low,37811,-7612
54,Male,Finance,10,86,77885,8,High,69128,8757
36,Female,Sales,5,57,44154,5,Medium,39468,4686
26,Female,Marketing,7,67,51849,6,Medium,49829,2020
42,Male,Operations,11,74,67217,7,High,73191,-5974
28,Male,Operations,8,58,53107,5,Medium,53892,-785
24,Female,IT,6,59,43260,5,Medium,44276,-1016
57,Female,Sales,4,70,43113,6,High,38791,4322
47,Female,Marketing,9,73,66595,7,High,63575,3020
42,Female,IT,7,84,47902,8,High,54704,-6802
51,Female,Marketing,4,59,30701,5,Medium,34660,-3959
28,Male,Finance,4,72,38179,7,High,39536,-1357
38,Female,Operations,3,77,30518,7,High,34728,-4210
53,Male,Marketing,5,58,43055,5,Medium,39468,3587
50,Male,Marketing,7,63,43833,6,Medium,49829,-5996
31,Male,Finance,15,73,84696,7,High,92422,-7726
24,Male,HR,4,75,36996,7,High,39536,-2540
46,Male,Operations,6,64,42299,6,Medium,45021,-2722
28,Female,Marketing,3,56,27678,5,Medium,29852,-2174
58,Female,Marketing,7,68,55132,6,Medium,49829,5303
41,Female,Operations,6,60,32462,6,Medium,45021,-12559
43,Female,Marketing,9,75,60981,7,High,63575,-2594
50,Male,Sales,6,57,45100,5,Medium,44276,824
41,Female,Finance,3,59,29314,5,Medium,29852,-538
44,Male,Finance,7,67,51277,6,Medium,49829,1448
22,Male,HR,3,60,27084,5,Medium,29852,-2768
53,Female,HR,10,56,58479,5,Medium,63507,-5028
26,Male,Finance,8,60,54249,6,Medium,54637,-388
47,Male,HR,8,72,54462,7,High,58767,-4305
44,Female,Finance,0,64,20534,6,Medium,16174,4360
36,Male,Sales,6,40,40656,4,Low,38556,2100
45,Female,Operations,6,79,58175,7,High,49152,9023
26,Female,Marketing,4,63,28625,6,Medium,35405,-6780
35,Male,Sales,5,88,34179,8,High,45089,-10910
56,Male,HR,2,72,24738,7,High,29920,-5182
52,Male,Operations,10,71,73663,7,High,68383,5280
50,Male,Marketing,2,68,28333,6,Medium,25789,2544
23,Female,Marketing,6,71,40127,7,High,49152,-9025
29,Male,Sales,12,80,92891,8,High,78744,14147
45,Male,Marketing,6,56,39906,5,Medium,44276,-4370
58,Female,Sales,13,71,92541,7,High,82806,9735
47,Male,IT,8,77,50660,7,High,58767,-8107
53,Female,IT,9,68,62454,6,Medium,59444,3010
48,Female,Finance,7,73,42645,7,High,53959,-11314
56,Female,IT,9,78,55689,7,High,63575,-7886
51,Female,HR,5,79,38741,7,High,44344,-5603
59,Male,Finance,6,54,38639,5,Medium,44276,-5637
52,Female,Finance,7,66,50567,6,Medium,49829,738
45,Male,Finance,3,66,34596,6,Medium,30597,3999
23,Female,Marketing,9,62,63655,6,Medium,59444,4211
30,Female,HR,3,57,35669,5,Medium,29852,5817
33,Male,HR,10,68,55627,7,Medium,64997,-9370
59,Female,HR,12,73,74232,7,High,77999,-3767
54,Female,IT,9,78,62280,7,High,63575,-1295
54,Female,Operations,6,63,52466,6,Medium,45021,7445
55,Female,Sales,3,47,28983,4,Medium,29107,-124
57,Female,Marketing,7,52,53177,5,Medium,49084,4093
30,Female,HR,0,57,21627,5,Medium,15429,6198
40,Female,Finance,5,49,35896,4,Medium,38723,-2827
40,Male,Marketing,7,85,46351,8,High,54704,-8353
48,Male,Marketing,0,70,20000,6,High,19559,441
52,Male,Sales,6,61,50624,6,Medium,45021,5603
44,Female,Finance,8,68,46370,6,Medium,54637,-8267
54,Male,Sales,5,76,43971,7,High,44344,-373
36,Male,Marketing,8,71,56845,7,High,58767,-1922
25,Female,Marketing,7,77,54809,7,High,53959,850
51,Female,Sales,10,81,72117,8,High,69128,2989
45,Female,IT,8,80,60454,8,High,59512,942
24,Male,IT,13,66,80453,6,Medium,78676,1777
22,Male,HR,9,84,63245,8,High,64320,-1075
50,Female,Operations,10,52,57339,5,Medium,63507,-6168
30,Female,HR,9,63,51628,6,Medium,59444,-7816
58,Male,HR,7,61,50164,6,Medium,49829,335
30,Female,Finance,5,71,48684,7,High,44344,4340
56,Male,HR,5,87,52162,8,High,45089,7073
44,Male,Sales,5,68,36926,6,Medium,40213,-3287
43,Male,Finance,11,70,66295,7,High,73191,-6896
54,Male,Marketing,10,75,64460,7,High,68383,-3923
47,Male,HR,5,61,43549,6,Medium,40213,3336
40,Male,IT,5,60,32274,6,Medium,40213,-7939
44,Male,IT,9,86,68003,8,High,64320,3683
27,Male,Operations,4,65,41649,6,Medium,35405,6244
57,Female,Marketing,8,62,50193,6,Medium,54637,-4444
44,Female,IT,10,87,73466,8,High,69128,4338
38,Male,Sales,8,53,53330,5,Medium,53892,-562
27,Female,Finance,6,80,47627,8,High,49897,-2270
27,Female,Sales,5,66,39684,6,Medium,40213,-529
53,Male,HR,6,73,57120,7,High,49152,7968
26,Male,HR,6,71,54799,7,High,49152,5647
58,Male,HR,8,88,61847,8,High,59512,2335
24,Female,Operations,7,77,54332,7,High,53959,373
23,Female,Operations,10,66,68961,6,Medium,64252,4709
50,Male,Finance,8,71,59838,7,High,58767,1071
37,Male,Marketing,12,70,76764,7,High,77999,-1235
32,Female,Sales,6,68,48070,6,Medium,45021,3049
57,Male,Sales,8,77,60919,7,High,58767,2152
35,Male,Sales,2,49,20000,4,Medium,24299,-4299
31,Female,Sales,4,73,36599,7,High,39536,-2937
59,Male,HR,8,66,60184,6,Medium,54637,5547
45,Male,Sales,11,51,66775,5,Medium,68315,-1540
32,Male,Sales,5,75,56502,7,High,44344,12158
23,Female,Finance,8,67,49211,6,Medium,54637,-5426
52,Female,Marketing,4,64,25005,6,Medium,35405,-10400
23,Female,Finance,5,64,37472,6,Medium,40213,-2741
22,Male,HR,7,73,55028,7,High,53959,1069
53,Male,Marketing,4,72,39788,7,High,39536,252
47,Female,Sales,6,60,52853,6,Medium,45021,7832
49,Female,Marketing,3,71,33176,7,High,34728,-1552
59,Female,Finance,7,68,56073,6,Medium,49829,6244
33,Female,Sales,11,64,67027,6,Medium,69060,-2033
56,Female,Finance,3,75,30986,7,High,34728,-3742
38,Female,Operations,1,79,20800,7,High,25112,-4312
34,Female,HR,10,59,60774,6,Medium,64252,-3478
35,Female,Finance,2,64,38532,6,Medium,25789,12743
34,Female,Marketing,7,61,51035,6,Medium,49829,1206
57,Female,Operations,5,55,35238,5,Medium,39468,-4230
22,Male,Marketing,5,57,48117,5,Medium,39468,8649
42,Female,Sales,9,83,69224,8,High,64320,4904
22,Female,Sales,5,63,39562,6,Medium,40213,-651
31,Male,Marketing,6,89,45804,8,High,49897,-4093
28,Male,Sales,8,79,62794,8,High,59512,3282
38,Female,Sales,6,56,35629,5,Medium,44276,-8647
49,Male,Sales,2,60,21704,5,Medium,25044,-3340
51,Male,Sales,0,63,20000,6,Medium,16174,3826
30,Male,Operations,2,80,23968,7,High,29920,-5952
28,Male,IT,4,59,33007,5,Medium,34660,-1653
36,Male,Finance,7,68,53272,6,Medium,49829,3443
48,Male,IT,6,50,50475,5,Medium,44276,6199
56,Female,Marketing,9,73,63220,7,High,63575,-355
51,Female,Operations,6,84,52474,8,High,49897,2577
49,Female,Finance,4,61,32426,6,Medium,35405,-2979
41,Female,Sales,4,66,37258,6,Medium,35405,1853
26,Male,HR,9,74,59839,7,High,63575,-3736
46,Female,Sales,3,69,34702,6,Medium,30597,4105
25,Female,Finance,4,63,35872,6,Medium,35405,467
23,Female,HR,7,58,44456,5,Medium,49084,-4628
35,Male,Marketing,5,60,49622,6,Medium,40213,9409
32,Male,HR,5,77,46496,7,High,44344,2152
58,Female,Operations,8,70,59367,7,High,58767,600
48,Female,Marketing,6,68,50513,6,Medium,45021,5492
48,Male,IT,1,70,21313,6,High,24367,-3054
46,Male,Sales,1,66,20000,6,Medium,20982,-982
59,Female,IT,7,76,49143,7,High,53959,-4816
47,Male,Operations,0,60,20000,5,Medium,15429,4571
22,Male,Marketing,7,76,47978,7,High,53959,-5981
29,Male,Finance,7,60,50550,6,Medium,49829,721
52,Male,Marketing,11,71,78618,7,High,73191,5427
33,Male,HR,9,73,63494,7,High,63575,-81
58,Female,Marketing,7,70,54911,7,High,53959,952
45,Male,Finance,7,62,46661,6,Medium,49829,-3168
47,Male,HR,8,74,60183,7,High,58767,1416
52,Male,Operations,13,47,80098,5,Medium,77931,2167
49,Female,Sales,7,60,66309,6,Medium,49829,16480
40,Female,Finance,9,55,58767,5,Medium,58699,68
51,Female,Marketing,5,69,45737,6,Medium,40213,5524
47,Male,Operations,8,63,56541,6,Medium,54637,1904
35,Male,Operations,8,78,50860,7,High,58767,-7907
41,Male,Finance,11,68,75309,7,Medium,69805,5504
40,Male,Sales,10,67,66105,6,Medium,64252,1853
54,Male,Finance,16,66,98902,7,Medium,93844,5058
44,Male,HR,8,67,54508,6,Medium,54637,-129
42,Female,Sales,9,82,60191,8,High,64320,-4129
46,Male,HR,11,75,66673,7,High,73191,-6518
53,Male,Finance,9,82,52066,8,High,64320,-12254
28,Male,Marketing,8,71,53527,7,High,58767,-5240
34,Male,Marketing,4,64,101904,6,Medium,35405,66499
32,Female,IT,11,70,71920,7,High,73191,-1271
26,Female,Marketing,8,58,59629,5,Medium,53892,5737
57,Male,Marketing,7,78,54391,7,High,53959,432
49,Male,Sales,4,78,36430,7,High,39536,-3106
23,Male,Sales,6,84,49210,8,High,49897,-687
41,Male,HR,1,76,25037,7,High,25112,-75
35,Female,Operations,6,85,50564,8,High,49897,667
58,Male,Finance,5,70,49411,7,High,44344,5067
53,Male,HR,8,49,50372,5,Medium,53892,-3520
51,Female,Sales,6,54,49639,5,Medium,44276,5363
36,Female,HR,6,85,53960,8,High,49897,4063
38,Female,Marketing,8,70,59521,7,High,58767,754
39,Male,Sales,8,71,57491,7,High,58767,-1276
47,Female,Finance,10,52,55405,5,Medium,63507,-8102
44,Female,Finance,1,77,20000,7,High,25112,-5112
58,Male,Finance,8,54,52094,5,Medium,53892,-1798
29,Male,HR,8,88,51343,8,High,59512,-8169
56,Male,Operations,8,69,61861,7,Medium,55381,6480
38,Female,HR,7,72,62856,7,High,53959,8897
30,Female,Marketing,6,73,50334,7,High,49152,1182
24,Female,Marketing,10,67,63906,6,Medium,64252,-346
46,Female,HR,4,70,29729,6,High,38791,-9062
32,Female,Finance,12,65,82943,6,Medium,73868,9075
25,Male,Sales,1,77,23931,7,High,25112,-1181
52,Female,HR,13,60,80282,6,Medium,78676,1606
40,Male,Finance,8,62,50295,6,Medium,54637,-4342
36,Female,Operations,9,55,56904,5,Medium,58699,-1795
37,Male,Finance,9,72,61954,7,High,63575,-1621
43,Male,Operations,10,64,62957,6,Medium,64252,-1295
29,Male,Marketing,5,70,38170,7,High,44344,-6174
53,Male,Operations,2,66,26792,6,Medium,25789,1003
40,Male,Operations,6,75,51155,7,High,49152,2003
27,Female,Marketing,2,71,23959,6,High,29175,-5216
44,Male,Finance,10,92,67992,9,High,69873,-1881
23,Female,Marketing,6,59,53478,5,Medium,44276,9202
59,Female,Finance,8,75,55102,7,High,58767,-3665
46,Male,IT,8,64,44133,6,Medium,54637,-10504
35,Female,Operations,4,58,35149,5,Medium,34660,489
44,Female,IT,6,77,45461,7,High,49152,-3691
37,Female,Sales,0,56,20000,5,Medium,15429,4571
48,Male,IT,5,83,42992,8,High,45089,-2097
54,Female,Marketing,7,85,51265,8,High,54704,-3439
45,Female,Operations,3,54,28729,5,Medium,29852,-1123
38,Female,Marketing,7,69,36073,6,Medium,49829,-13756
33,Female,IT,7,65,28822,6,Medium,49829,-21007
50,Male,Operations,4,59,29926,5,Medium,34660,-4734
25,Male,Sales,10,49,59660,5,Medium,63507,-3847
39,Female,Operations,8,62,52860,6,Medium,54637,-1777
58,Female,Finance,5,64,55637,6,Medium,40213,15424
35,Female,IT,8,82,60539,8,High,59512,1027
39,Male,Marketing,7,59,47164,6,Medium,49829,-2665
51,Male,HR,6,50,37142,5,Medium,44276,-7134
24,Male,Sales,2,89,24879,8,High,30665,-5786
43,Male,Finance,9,70,64268,7,High,63575,693
59,Male,Finance,8,81,65650,8,High,59512,6138
32,Female,Operations,8,73,60118,7,High,58767,1351
32,Male,IT,10,70,67088,7,High,68383,-1295
47,Male,IT,7,74,53740,7,High,53959,-219
54,Male,Finance,0,73,24387,7,High,20304,4083
33,Male,Finance,7,71,45861,7,High,53959,-8098
55,Female,Sales,5,76,42966,7,High,44344,-1378
31,Male,Operations,8,62,50018,6,Medium,54637,-4619
39,Male,Operations,4,82,40536,8,High,40281,255
30,Female,IT,7,62,47076,6,Medium,49829,-2753
54,Female,Operations,5,74,43090,7,High,44344,-1254
44,Male,Operations,0,73,20000,7,High,20304,-304
35,Female,IT,4,58,43135,5,Medium,34660,8475
23,Female,HR,4,82,40491,8,High,40281,210
49,Female,Marketing,9,70,65989,7,High,63575,2414
51,Female,Sales,4,61,35000,6,Medium,35405,-405
40,Female,IT,6,80,40999,8,High,49897,-8898
26,Male,Marketing,12,71,73440,7,High,77999,-4559
43,Male,Operations,5,76,47993,7,High,44344,3649
37,Female,HR,6,76,49492,7,High,49152,340
32,Female,IT,7,73,65018,7,High,53959,11059
45,Female,Finance,6,82,54250,8,High,49897,4353
24,Female,HR,4,74,29883,7,High,39536,-9653
49,Male,HR,9,74,62003,7,High,63575,-1572
30,Female,Marketing,8,71,101904,7,High,58767,43137
47,Female,Operations,10,63,66437,6,Medium,64252,2185
37,Female,Finance,5,80,43336,7,High,44344,-1008
27,Male,Operations,5,58,38621,5,Medium,39468,-847
58,Male,Operations,0,91,24685,8,High,21049,3636
51,Female,Sales,7,93,46876,9,High,55449,-8573
39,Male,Sales,11,83,71131,8,High,73936,-2805
27,Female,Finance,8,71,52816,7,High,58767,-5951
27,Female,HR,11,65,61702,6,Medium,69060,-7358
41,Male,Sales,8,77,56802,7,High,58767,-1965
56,Male,Operations,9,82,66045,8,High,64320,1725
49,Male,Marketing,6,70,39412,7,High,49152,-9740
53,Female,Marketing,13,58,81383,6,Medium,78676,2707
27,Male,Finance,4,60,34493,5,Medium,34660,-167
24,Female,Marketing,11,61,55515,6,Medium,69060,-13545
35,Female,Finance,8,63,52877,6,Medium,54637,-1760
43,Male,HR,8,73,53607,7,High,58767,-5160
46,Female,Finance,7,68,51516,6,Medium,49829,1687
24,Male,Sales,4,54,33397,5,Medium,34660,-1263
46,Male,Marketing,5,60,41521,6,Medium,40213,1308
26,Male,IT,6,75,43565,7,High,49152,-5587
22,Female,Finance,5,58,32933,5,Medium,39468,-6535
49,Male,HR,6,71,44449,7,High,49152,-4703
31,Female,HR,8,60,56795,6,Medium,54637,2158
47,Male,Sales,10,80,70671,8,High,69128,1543
49,Female,Finance,7,74,74265,7,High,53959,20306
22,Male,Operations,9,77,57459,7,High,63575,-6116
56,Male,Sales,6,67,45148,6,Medium,45021,127
31,Female,Sales,6,56,36131,5,Medium,44276,-8145
51,Male,Operations,6,65,48283,6,Medium,45021,3262
22,Female,HR,10,79,66210,8,High,69128,-2918
57,Female,Sales,8,63,59138,6,Medium,54637,4501
55,Female,IT,7,49,44770,5,Medium,49084,-4314
36,Male,Finance,13,84,81623,8,High,83551,-1928
43,Female,Finance,9,76,62996,7,High,63575,-579
45,Male,HR,8,87,57594,8,High,59512,-1918
47,Male,IT,5,69,40885,6,Medium,40213,672
38,Female,HR,14,63,94919,6,Medium,83484,11435
44,Female,Sales,2,71,21630,6,High,29175,-7545
46,Male,Sales,3,61,28129,6,Medium,30597,-2468
45,Male,Marketing,6,79,45805,7,High,49152,-3347
43,Male,HR,9,46,53161,4,Medium,57954,-4793
47,Female,Operations,6,67,44715,6,Medium,45021,-306
44,Female,Sales,9,79,69818,8,High,64320,5498
47,Male,Finance,13,68,88555,7,Medium,79421,9134
55,Male,Finance,6,81,45530,8,High,49897,-4367
51,Male,Sales,8,65,51933,6,Medium,54637,-2704
23,Female,Operations,4,70,29667,6,High,38791,-9124
49,Female,IT,6,63,49174,6,Medium,45021,4153
38,Male,Operations,0,65,20000,6,Medium,16174,3826
30,Male,Sales,7,62,56555,6,Medium,49829,6726
37,Female,Finance,10,81,77446,8,High,69128,8318
23,Male,Sales,8,88,57441,8,High,59512,-2071
29,Male,IT,1,63,20000,6,Medium,20982,-982
34,Male,Operations,9,92,68535,9,High,65065,3470
26,Female,Sales,5,72,45039,7,High,44344,695
38,Female,Finance,7,76,56221,7,High,53959,2262
22,Female,Finance,9,86,55564,8,High,64320,-8756
32,Male,IT,4,84,36459,8,High,40281,-3822
35,Male,HR,8,73,52066,7,High,58767,-6701
31,Male,IT,7,86,53662,8,High,54704,-1042
52,Male,Sales,4,70,46748,6,High,38791,7957
59,Male,Finance,3,84,23198,8,High,35473,-12275
32,Male,HR,7,69,42869,6,Medium,49829,-6960
54,Male,IT,4,68,39559,6,Medium,35405,4154
47,Male,HR,7,75,49806,7,High,53959,-4153
54,Male,Operations,5,74,37492,7,High,44344,-6852
49,Male,IT,10,75,65883,7,High,68383,-2500
55,Male,Marketing,9,64,60716,6,Medium,59444,1272
25,Female,Finance,6,69,44834,6,Medium,45021,-187
36,Female,Marketing,9,64,58504,6,Medium,59444,-940
24,Female,Sales,6,60,37488,6,Medium,45021,-7533
52,Male,Marketing,6,78,52345,7,High,49152,3193
43,Male,Operations,4,82,37410,8,High,40281,-2871
26,Male,Marketing,6,60,51260,6,Medium,45021,6239
52,Female,IT,6,81,49599,8,High,49897,-298
28,Male,Operations,9,60,67412,6,Medium,59444,7968
52,Male,Finance,7,79,37337,7,High,53959,-16622
37,Female,Operations,0,58,20000,5,Medium,15429,4571
33,Female,Sales,7,68,52727,6,Medium,49829,2898
58,Female,Operations,1,79,26525,7,High,25112,1413
34,Male,Marketing,1,72,29237,7,High,25112,4125
38,Male,IT,7,51,42224,5,Medium,49084,-6860
43,Female,Finance,11,59,66061,6,Medium,69060,-2999
41,Female,HR,8,65,51779,6,Medium,54637,-2858
41,Female,IT,6,86,45658,8,High,49897,-4239
23,Female,Sales,6,72,52622,7,High,49152,3470
50,Female,Sales,4,68,30022,6,Medium,35405,-5383
44,Female,Finance,12,83,81569,8,High,78744,2825
57,Female,IT,10,72,65638,7,High,68383,-2745
44,Male,Finance,12,67,75985,7,Medium,74613,1372
41,Male,Sales,4,54,25879,5,Medium,34660,-8781
22,Male,Marketing,4,72,41997,7,High,39536,2461
33,Male,IT,6,72,44204,7,High,49152,-4948
51,Female,Finance,11,77,79372,7,High,73191,6181
27,Female,IT,8,52,58986,5,Medium,53892,5094
46,Female,Finance,7,55,54857,5,Medium,49084,5773
36,Female,Marketing,8,71,54932,7,High,58767,-3835
27,Male,Finance,5,76,35956,7,High,44344,-8388
38,Female,Finance,9,75,64807,7,High,63575,1232
36,Female,Sales,8,59,59138,6,Medium,54637,4501
56,Female,Operations,3,78,25303,7,High,34728,-9425
49,Female,Sales,2,65,21727,6,Medium,25789,-4062
28,Male,Sales,5,58,36138,5,Medium,39468,-3330
38,Male,Finance,8,72,55178,7,High,58767,-3589
27,Male,Sales,5,89,45567,8,High,45089,478
33,Male,IT,5,70,43290,7,High,44344,-1054
40,Male,Operations,8,71,52925,7,High,58767,-5842
36,Female,IT,8,70,71021,7,High,58767,12254
44,Female,Sales,3,76,35943,7,High,34728,1215
33,Female,Operations,5,85,52791,8,High,45089,7702
42,Female,Operations,5,71,45531,7,High,44344,1187
22,Female,Operations,9,54,64772,5,Medium,58699,6073
26,Male,IT,9,83,51410,8,High,64320,-12910
40,Female,Finance,4,77,48858,7,High,39536,9322
47,Male,Operations,2,76,24647,7,High,29920,-5273
57,Male,HR,1,55,26744,5,Medium,20237,6507
58,Male,IT,7,86,53764,8,High,54704,-940
